11111111111111111111
100000000000C0000001
1C000P000C00000000E1
100000000000000C0001
11111111111111111111
